::::::::::::::::::::::::::::::::::::::::::::::::::::::::::::
::::::::::::::::::::::::::::::::::::::::::::::::::::::::::::
:::::::::::::::^^^^^^^^^^^^^^^^^^^^^^^^^^^^^^:::::::::::::::
::::::::::^^^^^^^^^^^^^^^^^^^^^^^^^^^^^^^^^^^^^^^^::::::::::
:::::::^^^^^^^^^..............^^............^^^^^^^^^:::::::
:::::^^^^^^...................^^.................^^^^^^:::::
::::^^^^......................^^....................^^^^::::
:::^^^^.......................^^.....................^^^^:::
:::^^^........................^^......................^^^:::
:::^^^.....P..................^^......................^^^:::
:::^^^........................^^................S.....^^^:::
:::^^^........................^^......................^^^:::
:::^^^^.......................^^.....................^^^^:::
::::^^^^......................^^....................^^^^::::
:::::^^^^^^...................^^.................^^^^^^:::::
:::::::^^^^^^^^^..............^^............^^^^^^^^^:::::::
::::::::::^^^^^^^^^^^^^^^^^^^^^^^^^^^^^^^^^^^^^^^^::::::::::
:::::::::::::::^^^^^^^^^^^^^^^^^^^^^^^^^^^^^^:::::::::::::::
::::::::::::::::::::::::::::::::::::::::::::::::::::::::::::
::::::::::::::::::::::::::::::::::::::::::::::::::::::::::::
