.########..########..########..########..########..########.
.#^^^^^^#..#^^^^^^#..#^^^^^^#..#^^^^^^#..#^^^^^^#..#^^^^^^#.
.#^^^^^^#..#^^^^^^#..#^^^^^^#..#^^^^^^#S.#^^^^^^#..#^^^^^^#.
.#^^^^^^#..#^^^^^^#..#^^^^^^#..#^^^^^^#..#^^^^^^#..#^^^^^^#.
.#^^^^^^#..#^^^^^^#..#^^^^^^#..#^^^^^^#..#^^^^^^#..#^^^^^^#.
.########..########..########..########..########..########.
............................................................
.########..########..########..########..########..########.
.#^^^^^^#..#^^^^^^#..#^^^^^^#..#^^^^^^#..#^^^^^^#..#^^^^^^#.
.#^^^^^^#..#^^^^^^#..#^^^^^^#..#^^^^^^#..#^^^^^^#..#^^^^^^#.
.#^^^^^^#..#^^^^^^#..#^^^^^^#..#^^^^^^#..#^^^^^^#..#^^^^^^#.
.#^^^^^^#..#^^^^^^#..#^^^^^^#..#^^^^^^#..#^^^^^^#..#^^^^^^#.
.########..########..########..########..########..########.
...........................................................*
.########..########..########..########..########..########.
.#^^^^^^#..#^^^^^^#..#^^^^^^#..#^^^^^^#..#^^^^^^#..#^^^^^^#.
.#^^^^^^#..#^^^^^^#..#^^^^^^#..#^^^^^^#..#^^^^^^#..#^^^^^^#.
.#^^^^^^#..#^^^^^^#.P#^^^^^^#..#^^^^^^#..#^^^^^^#..#^^^^^^#.
.#^^^^^^#..#^^^^^^#..#^^^^^^#..#^^^^^^#..#^^^^^^#..#^^^^^^#.
.########..########..########..########..########..########.