.....###.....###.....###.....###.....###.....###.....###....
.###.###.###.###.###.###.###.###.###.###.###.###.###.###.###
.#::.:::.::#.###.#::.:::.::#.###.#::.:::.::#.###.#::.:::.::#
.#:#.###.#:#.###.#:#.###.#:#.###.#:#.###.#:#.###.#:#.###.#:#
.....###.....###.....###.....###.....###.....###.....###....
##:#######:#######:#######:#######:#######:#######:#######:#
##:###....:...P...:....###:#######:###....:...S...:....###:#
##:###.###:#######:###.###:#######:###.###:#######:###.###:#
.....#.#.....###.....#.#.....###.....#.#.....###.....#.#....
.#:#.#.#.#:#.###.#:#.#.#.#:#.###.#:#.#.#.#:#.###.#:#.#.#.#:#
.#::.:::.::#.###.#::.:::.::#.###.#::.:::.::#.###.#::.:::.::#
.###.#.#.###.###.###.#.#.###.###.###.#.#.###.###.###.#.#.###
.....#.#.....###.....#.#.....###.....#.#.....###.....#.#....
######.###############.###############.###############.#####
######.#######::::::::.:::::::::::::::.::::::::#######*#####
######.#######:#######.###############.#######:#######.#####
.....#.#.....#:#.....#.#.....###.....#.#.....#:#.....#.#....
.###.#.#.###.#:#.###.#.#.###.###.###.#.#.###.#:#.###.#.#.###
.#::.:::.::#.#:#.#::.:::.::#.###.#::.:::.::#.#:#.#::.:::.::#
.#:#.#.#.#:#.#:#.#:#.#.#.#:#.###.#:#.#.#.#:#.#:#.#:#.#.#.#:#